03 03 03 03 90 60 60 60 60 60 60 60 60 60 60 60 60 60 60 60 60 60 60 91 03 03 03 03 
03 03 03 03 63 01 01 01 01 01 01 01 01 01 01 01 01 01 01 01 01 01 01 33 60 60 91 03 
03 03 03 03 63 01 30 62 62 31 01 30 62 62 62 31 01 30 31 01 30 31 01 01 01 01 61 03 
03 03 03 03 63 01 61 03 03 63 01 61 03 03 03 63 01 61 63 01 61 93 62 62 31 01 61 03 
90 60 60 60 32 01 33 60 60 32 01 33 60 91 03 63 01 33 32 01 33 60 60 60 32 01 61 03 
63 01 01 01 01 01 01 01 01 01 01 01 01 61 03 63 01 01 01 01 01 01 01 01 01 01 33 91 
63 01 30 31 01 30 62 62 62 62 62 31 01 61 03 63 01 30 62 62 62 31 01 30 31 01 01 61 
63 01 61 63 01 61 03 03 03 03 03 63 01 61 03 63 01 61 03 03 03 63 01 61 93 31 01 61 
63 01 61 63 01 61 03 90 60 60 60 32 01 33 60 32 01 33 60 60 60 32 01 61 03 63 01 61 
63 01 33 32 01 61 03 63 01 01 01 01 01 01 01 01 01 01 01 01 01 01 01 61 90 32 01 61 
63 01 01 01 01 61 03 63 01 30 62 62 62 31 01 30 62 62 62 62 31 01 30 92 63 01 01 61 
63 01 30 31 01 33 60 32 01 33 60 60 60 32 01 33 60 60 60 60 32 01 33 91 63 01 30 92 
63 01 61 63 01 01 01 01 01 01 01 01 01 01 01 01 01 01 01 01 01 01 01 33 32 01 61 03 
63 01 61 93 31 01 30 62 31 01 40 22 22 52 52 22 22 41 01 30 62 31 01 01 01 01 61 03 
32 01 61 03 63 01 61 03 63 01 21 00 00 00 00 00 00 23 01 61 03 63 01 30 31 01 33 60 
01 01 61 03 63 01 61 03 63 01 21 00 00 00 00 00 00 23 01 61 03 63 01 61 63 01 01 01 
31 01 61 03 63 01 33 60 32 01 21 00 00 00 00 00 00 23 01 61 03 63 01 61 93 31 01 30 
63 01 61 03 63 01 01 01 01 01 43 20 20 20 20 20 20 42 01 61 03 63 01 61 03 63 01 61 
63 01 33 60 32 01 30 62 31 01 01 01 01 01 01 01 01 01 01 61 03 63 01 61 03 63 01 61 
63 01 01 01 01 01 61 03 93 31 01 30 62 31 01 30 62 31 01 61 03 63 01 33 60 32 01 61 
63 01 30 62 31 01 33 60 60 32 01 33 60 32 01 61 03 63 01 61 03 63 01 01 01 01 01 61 
63 01 33 60 32 01 01 01 01 01 01 01 01 01 01 61 03 63 01 61 03 63 01 30 62 31 01 61 
63 01 01 01 01 01 30 31 01 30 62 62 62 31 01 33 60 32 01 61 03 63 01 61 03 63 01 61 
93 31 01 30 62 62 92 63 01 61 03 03 03 63 01 01 01 01 01 61 03 63 01 61 03 63 01 61 
03 63 01 61 03 03 03 63 01 61 03 03 03 93 62 62 62 31 01 33 60 32 01 61 03 63 01 61 
03 63 01 61 03 03 03 63 01 61 03 03 03 03 03 03 03 63 01 01 01 01 01 33 60 32 01 61 
03 63 01 61 03 03 90 32 01 33 60 60 60 91 03 03 03 93 31 01 30 31 01 01 01 01 01 61 
03 63 01 61 03 03 63 01 01 01 01 01 01 61 03 03 03 03 63 01 61 63 01 30 62 31 01 61 
03 63 01 33 60 60 32 01 30 62 62 31 01 33 60 60 60 60 32 01 33 32 01 33 60 32 01 61 
03 63 01 01 01 01 01 01 61 03 03 63 01 01 01 01 01 01 01 01 01 01 01 01 01 01 01 61 
03 93 62 62 62 62 62 62 92 03 03 93 62 62 62 62 62 62 62 62 62 62 62 62 62 62 62 92 
