10 20 20 20 20 20 20 20 20 20 20 20 20 81 70 20 20 20 20 20 20 20 20 20 20 20 20 11 
23 01 01 01 01 01 01 01 01 01 01 01 01 61 63 01 01 01 01 01 01 01 01 01 01 01 01 21 
23 01 30 62 62 31 01 30 62 62 62 31 01 61 63 01 30 62 62 62 31 01 30 62 62 31 01 21 
23 02 61 03 03 63 01 61 03 03 03 63 01 61 63 01 61 03 03 03 63 01 61 03 03 63 02 21 
23 01 33 60 60 32 01 33 60 60 60 32 01 33 32 01 33 60 60 60 32 01 33 60 60 32 01 21 
23 01 01 01 01 01 01 01 01 01 01 01 01 01 01 01 01 01 01 01 01 01 01 01 01 01 01 21 
23 01 30 62 62 31 01 30 31 01 30 62 62 62 62 62 62 31 01 30 31 01 30 62 62 31 01 21 
23 01 33 60 60 32 01 61 63 01 33 60 60 91 90 60 60 32 01 61 63 01 33 60 60 32 01 21 
23 01 01 01 01 01 01 61 63 01 01 01 01 61 63 01 01 01 01 61 63 01 01 01 01 01 01 21 
13 22 22 22 22 31 01 61 93 62 62 31 00 61 63 00 30 62 62 92 63 01 30 22 22 22 22 12 
00 00 00 00 00 23 01 61 90 60 60 32 00 33 32 00 33 60 60 91 63 01 21 00 00 00 00 00 
00 00 00 00 00 23 01 61 63 00 00 00 00 00 00 00 00 00 00 61 63 01 21 00 00 00 00 00 
00 00 00 00 00 23 01 61 63 00 40 22 22 52 52 22 22 41 00 61 63 01 21 00 00 00 00 00 
20 20 20 20 20 32 01 33 32 00 21 00 00 00 00 00 00 23 00 33 32 01 33 20 20 20 20 20 
00 00 00 00 00 00 01 00 00 00 21 00 00 00 00 00 00 23 00 00 00 01 00 00 00 00 00 00 
22 22 22 22 22 31 01 30 31 00 21 00 00 00 00 00 00 23 00 30 31 01 30 22 22 22 22 22 
00 00 00 00 00 23 01 61 63 00 43 20 20 20 20 20 20 42 00 61 63 01 21 00 00 00 00 00 
00 00 00 00 00 23 01 61 63 00 00 00 00 00 00 00 00 00 00 61 63 01 21 00 00 00 00 00 
00 00 00 00 00 23 01 61 63 00 30 62 62 62 62 62 62 31 00 61 63 01 21 00 00 00 00 00 
10 20 20 20 20 32 01 33 32 00 33 60 60 91 90 60 60 32 00 33 32 01 33 20 20 20 20 11 
23 01 01 01 01 01 01 01 01 01 01 01 01 61 63 01 01 01 01 01 01 01 01 01 01 01 01 21 
23 01 30 62 62 31 01 30 62 62 62 31 01 61 63 01 30 62 62 62 31 01 30 62 62 31 01 21 
23 01 33 60 91 63 01 33 60 60 60 32 01 33 32 01 33 60 60 60 32 01 61 90 60 32 01 21 
23 02 01 01 61 63 01 01 01 01 01 01 01 00 00 01 01 01 01 01 01 01 61 63 01 01 02 21 
73 62 31 01 61 63 01 30 31 01 30 62 62 62 62 62 62 31 01 30 31 01 61 63 01 30 62 82 
80 60 32 01 33 32 01 61 63 01 33 60 60 91 90 60 60 32 01 61 63 01 33 32 01 33 60 71 
23 01 01 01 01 01 01 61 63 01 01 01 01 61 63 01 01 01 01 61 63 01 01 01 01 01 01 21 
23 01 30 62 62 62 62 92 93 62 62 31 01 61 63 01 30 62 62 92 93 62 62 62 62 31 01 21 
23 01 33 60 60 60 60 60 60 60 60 32 01 33 32 01 33 60 60 60 60 60 60 60 60 32 01 21 
23 01 01 01 01 01 01 01 01 01 01 01 01 01 01 01 01 01 01 01 01 01 01 01 01 01 01 21 
13 22 22 22 22 22 22 22 22 22 22 22 22 22 22 22 22 22 22 22 22 22 22 22 22 22 22 12 
