10 20 11 00 23 00 21 00 00 00 00 00 00 00 00 00 00 00 00 00 00 23 00 21 00 10 20 11 
23 02 21 00 23 00 21 00 00 00 00 00 00 00 00 00 00 00 00 00 00 23 00 21 00 23 02 21 
23 01 21 00 23 00 21 00 00 00 00 00 00 00 00 00 00 00 00 00 00 23 00 21 00 23 01 21 
23 01 33 20 32 00 33 20 20 20 20 20 20 20 20 20 20 20 20 20 20 32 00 33 20 32 01 21 
23 01 01 01 01 01 01 01 01 01 00 00 00 00 00 00 00 00 01 01 01 01 01 01 01 01 01 21 
23 01 30 31 01 30 22 22 31 01 30 22 22 31 01 30 22 31 01 30 22 22 31 01 30 31 01 21 
23 01 21 23 01 21 10 20 32 01 21 03 03 23 01 21 03 23 01 33 20 11 23 01 21 23 01 21 
23 01 21 23 01 21 23 00 00 01 33 20 20 32 01 33 20 32 01 00 00 21 23 01 21 23 01 21 
23 01 21 23 01 21 13 22 31 01 01 01 01 01 01 01 01 01 01 30 22 12 23 01 21 23 01 21 
23 01 33 32 01 33 20 20 32 01 30 22 31 01 30 22 22 31 01 33 20 20 32 01 33 32 01 21 
23 01 01 01 01 01 01 01 01 01 21 03 23 01 21 03 03 23 01 01 01 01 01 01 01 01 01 21 
13 22 22 22 22 31 01 30 31 00 33 20 32 01 33 20 20 32 00 30 31 01 30 22 22 22 22 12 
00 00 00 00 00 23 01 21 23 00 00 00 00 00 00 00 00 00 00 21 23 01 21 00 00 00 00 00 
00 00 00 00 00 23 01 21 23 00 40 22 22 52 52 22 22 41 00 21 23 01 21 00 00 00 00 00 
20 20 20 20 20 32 01 21 23 00 21 00 00 00 00 00 00 23 00 21 23 01 33 20 20 20 20 20 
00 01 01 01 01 01 01 21 23 00 21 00 00 00 00 00 00 23 00 21 23 01 01 01 01 01 01 00 
22 22 22 22 22 31 01 21 23 00 21 00 00 00 00 00 00 23 00 21 23 01 30 22 22 22 22 22 
00 00 00 00 00 23 01 21 23 00 43 20 20 20 20 20 20 42 00 21 23 01 21 00 00 00 00 00 
00 00 00 00 00 23 01 21 23 00 00 00 00 00 00 00 00 00 00 21 23 01 21 00 00 00 00 00 
10 20 20 20 20 32 01 33 32 00 30 22 22 31 01 30 22 31 00 33 32 01 33 20 20 20 20 11 
23 01 01 01 01 01 01 01 01 01 21 03 03 23 01 21 03 23 01 01 01 01 01 01 01 01 01 21 
23 01 30 31 01 30 22 22 31 01 33 20 20 32 01 33 20 32 01 30 22 22 31 01 30 31 01 21 
23 01 21 23 01 21 10 20 32 01 01 01 01 01 01 01 01 01 01 33 20 11 23 01 21 23 01 21 
23 01 21 23 01 21 23 00 00 01 30 22 31 01 30 22 22 31 01 00 00 21 23 01 21 23 01 21 
23 01 21 23 01 21 13 22 31 01 21 03 23 01 21 03 03 23 01 30 22 12 23 01 21 23 01 21 
23 01 33 32 01 33 20 20 32 01 33 20 32 01 33 20 20 32 01 33 20 20 32 01 33 32 01 21 
23 01 01 01 01 01 01 01 01 01 00 00 00 00 00 00 00 00 01 01 01 01 01 01 01 01 01 21 
23 01 30 22 31 00 30 22 22 22 22 22 22 22 22 22 22 22 22 22 22 31 00 30 22 31 01 21 
23 01 21 00 23 00 21 00 00 00 00 00 00 00 00 00 00 00 00 00 00 23 00 21 00 23 01 21 
23 02 21 00 23 00 21 00 00 00 00 00 00 00 00 00 00 00 00 00 00 23 00 21 00 23 02 21 
13 22 12 00 23 00 21 00 00 00 00 00 00 00 00 00 00 00 00 00 00 23 00 21 00 13 22 12 
