10 20 20 20 20 11 23 00 21 10 20 20 20 20 20 20 20 20 11 23 00 21 10 20 20 20 20 11 
23 00 00 00 00 61 63 00 61 63 00 00 00 00 00 00 00 00 61 63 00 61 63 00 00 00 00 21 
23 00 00 00 00 61 63 00 61 63 00 00 00 00 00 00 00 00 61 63 00 61 63 00 00 00 00 21 
23 00 00 00 00 61 63 00 61 63 00 00 00 00 00 00 00 00 61 63 00 61 63 00 00 00 00 21 
23 00 00 00 00 33 32 00 33 32 00 00 00 00 00 00 00 00 33 32 00 33 32 00 00 00 00 21 
23 00 00 00 00 00 00 00 00 00 00 00 00 00 00 00 00 00 00 00 00 00 00 00 00 00 00 21 
23 00 00 00 00 00 00 00 00 00 00 00 00 00 00 00 00 00 00 00 00 00 00 00 00 00 00 21 
23 00 00 00 00 00 00 00 00 00 00 00 00 00 00 00 00 00 00 00 00 00 00 00 00 00 00 21 
23 00 00 00 00 00 00 00 00 00 00 00 00 00 00 00 00 00 00 00 00 00 00 00 00 00 00 21 
23 00 00 00 00 00 00 00 00 00 00 00 00 00 00 00 00 00 00 00 00 00 00 00 00 00 00 21 
23 00 00 00 00 00 00 00 00 00 00 00 00 00 00 00 00 00 00 00 00 00 00 00 00 00 00 21 
23 00 00 00 00 00 00 00 00 00 00 00 00 00 00 00 00 00 00 00 00 00 00 00 00 00 00 21 
23 00 00 00 00 00 00 00 00 00 00 00 00 00 00 00 00 00 00 00 00 00 00 00 00 00 00 21 
23 00 00 00 00 00 00 00 00 00 00 00 00 00 00 00 00 00 00 00 00 00 00 00 00 00 00 21 
32 00 00 00 00 00 00 00 00 00 00 00 00 00 00 00 00 00 00 00 00 00 00 00 00 00 00 33 
00 00 00 00 00 00 00 00 00 00 00 00 00 00 00 00 00 00 00 00 00 00 00 00 00 00 00 00 
31 00 00 00 00 00 00 00 00 00 00 00 00 00 00 00 00 00 00 00 00 00 00 00 00 00 00 30 
23 00 00 00 00 00 00 00 00 00 00 00 00 00 00 00 00 00 00 00 00 00 00 00 00 00 00 21 
23 00 00 00 00 00 00 00 00 00 00 00 00 00 00 00 00 00 00 00 00 00 00 00 00 00 00 21 
23 00 00 00 00 00 00 00 00 00 00 00 00 00 00 00 00 00 00 00 00 00 00 00 00 00 00 21 
23 00 00 00 00 00 00 00 00 00 00 00 00 00 00 00 00 00 00 00 00 00 00 00 00 00 00 21 
23 00 00 00 00 00 00 00 00 00 00 00 00 00 00 00 00 00 00 00 00 00 00 00 00 00 00 21 
23 00 00 00 00 00 00 00 00 00 00 00 00 00 00 00 00 00 00 00 00 00 00 00 00 00 00 21 
23 00 00 00 00 00 00 00 00 00 00 00 00 00 00 00 00 00 00 00 00 00 00 00 00 00 00 21 
23 00 00 00 00 00 00 00 00 00 00 00 00 00 00 00 00 00 00 00 00 00 00 00 00 00 00 21 
23 00 00 00 00 00 00 00 00 00 00 00 00 00 00 00 00 00 00 00 00 00 00 00 00 00 00 21 
23 00 00 00 00 30 31 00 30 31 00 00 00 00 00 00 00 00 30 31 00 30 31 00 00 00 00 21 
23 00 00 00 00 61 63 00 61 63 00 00 00 00 00 00 00 00 61 63 00 61 63 00 00 00 00 21 
23 00 00 00 00 61 63 00 61 63 00 00 00 00 00 00 00 00 61 63 00 61 63 00 00 00 00 21 
23 00 00 00 00 61 63 00 61 63 00 00 00 00 00 00 00 00 61 63 00 61 63 00 00 00 00 21 
13 22 22 22 22 12 23 00 21 13 22 22 22 22 22 22 22 22 12 23 00 21 13 22 22 22 22 12 
