10 20 20 20 20 20 20 20 20 20 20 20 20 20 20 20 20 20 20 20 20 20 20 20 20 20 20 11 
23 00 00 00 00 00 00 00 00 00 00 00 00 00 00 00 00 00 00 00 00 00 00 00 00 00 00 21 
23 00 00 00 00 00 10 20 20 20 20 11 00 00 00 00 00 00 00 00 00 00 00 00 00 00 00 21 
23 00 00 00 00 00 23 30 22 31 00 21 00 00 00 00 00 00 00 00 00 00 00 00 00 00 00 21 
23 00 00 00 00 00 23 21 00 23 00 21 00 00 00 00 00 00 00 00 00 00 00 00 00 00 00 21 
23 00 00 00 00 00 23 21 00 23 00 21 00 00 00 00 00 00 00 00 00 00 00 00 00 00 00 21 
23 00 00 00 00 00 23 21 00 23 00 21 00 00 00 00 00 00 00 30 22 31 10 20 11 00 00 21 
23 00 00 00 00 00 23 21 00 23 00 21 00 00 00 00 00 00 00 21 00 23 23 00 21 00 00 21 
23 00 00 00 00 00 23 21 00 23 00 21 00 00 00 00 00 00 00 33 20 32 13 22 12 00 00 21 
23 00 00 00 00 00 23 21 00 23 00 21 00 00 00 00 00 00 00 00 00 00 00 00 00 00 00 21 
23 00 00 00 00 00 23 21 00 23 00 21 00 00 00 00 00 00 00 00 00 00 00 00 00 00 00 21 
23 00 00 00 00 00 23 33 20 32 00 21 00 00 00 00 00 00 00 00 00 00 00 00 00 00 00 21 
23 00 00 00 00 00 23 00 00 00 00 21 00 00 00 00 00 00 00 00 00 00 00 00 00 00 00 21 
23 00 00 00 00 00 13 22 22 22 22 12 00 00 00 00 00 00 00 00 00 00 00 00 00 00 00 21 
23 00 00 00 00 00 00 00 00 00 00 00 00 00 00 00 00 00 00 00 00 00 00 00 00 00 00 21 
23 00 00 00 00 00 00 00 00 00 00 00 00 00 00 00 00 00 00 00 00 00 00 00 00 00 00 21 
23 00 00 00 00 00 00 00 00 00 00 00 00 00 00 00 00 00 00 00 00 00 00 00 00 00 00 21 
23 00 00 00 00 00 00 00 00 00 00 00 00 00 00 00 00 00 00 00 00 00 00 00 00 00 00 21 
23 00 00 00 00 00 00 00 00 00 00 00 00 00 00 00 00 00 00 00 00 00 00 00 00 00 00 21 
23 00 00 00 00 00 00 00 00 00 00 00 00 00 00 00 00 00 00 00 00 00 00 00 00 00 00 21 
23 00 00 00 00 00 00 00 00 00 00 00 00 00 00 00 00 00 00 00 00 00 00 00 00 00 00 21 
23 00 00 00 00 00 00 00 00 00 00 00 00 00 00 00 00 00 00 00 00 00 00 00 00 00 00 21 
23 00 00 00 00 00 00 00 00 00 00 00 00 00 00 00 00 00 00 00 00 00 00 00 00 00 00 21 
23 00 00 00 00 00 00 00 00 00 00 00 00 00 00 00 00 00 00 00 00 00 00 00 00 00 00 21 
23 00 00 00 00 00 00 00 00 00 00 00 00 00 00 00 00 00 00 00 00 00 00 00 00 00 00 21 
23 00 00 00 00 00 00 00 00 00 00 00 00 00 00 00 00 00 00 00 00 00 00 00 00 00 00 21 
23 00 00 00 00 00 00 00 00 00 00 00 00 00 00 00 00 00 00 00 00 00 00 00 00 00 00 21 
23 00 00 00 00 00 00 00 00 00 00 00 00 00 00 00 00 00 00 00 00 00 00 00 00 00 00 21 
23 00 00 00 00 00 00 00 00 00 00 00 00 00 00 00 00 00 00 00 00 00 00 00 00 00 00 21 
23 00 00 00 00 00 00 00 00 00 00 00 00 00 00 00 00 00 00 00 00 00 00 00 00 00 00 21 
13 22 22 22 22 22 22 22 22 22 22 22 22 22 22 22 22 22 22 22 22 22 22 22 22 22 22 12 
